1111111111111111111111111111111
1MMMMMMMMMMMMMMMMMMMMMMMMMMMMM1
1MMM11111111MMMMMMMMMMMMMMMMMM1
1MMM1.....1MMMMMMMMMMMMMMMMMM.1
1MMM1.P..  MMMMMMMMMMMMMMMMMMM1
1MMM1.....1MMMMMMMMMMMMMMMMMMM1
1MMM11111111MMMMMMMMMMMMMMMMM1
1MMMMMMMMMM11MMMMMMMMMMMMMMMMM1
1MMMMMMMMMMMMMMMMMMMMMMMMMMMMM1
1MMMM11MMMMMMMMMMMMMMMMMMMMMMM1
1MMMMMMMMMMMMMMMMMMMMMMMMMMMMM1
1MMMMMMMMMMMMMMMMMMMMMMMMMMMMM1
1MMMMMMMMMMMMMMMMMMMMMMMMMMMMM1
1MMMMMMMMMMMMMMMMMMMMMMMMMMMMM1
1MMMMMMMMMMMMMMMMMMMMMMMMMMMMM1
1MMMMMMMMMMMMMMMMMMMMMMMMMMMMM1
1MMMMMMMMMMMMMMMMMMMMMMMMMMMMM1
1MMMMMMMMMMMMMMMMMMMMMMMMMMMMM1
1MMMMMMMMMMMMMMMMMMMMMMMMMMMMM1
1MMMMMMMMMMMMMMMMMMMMMMMMMMMMM1
1MMMMMMMMMMMMMMMMMMMMMMMMMMMMM1
1MMMMMMMMMMMMMMMMMMMMMMMMMMMMM1
1MMMMMMMMMMMMMMMMMMMMMMMMMMMMM1
1111111111111111111111111111111
